
NO cub3d.h
SO cub3d.h    test
WE cub3d.h

EA cub3d.h
SO cub3d.h


F 0,76,211
C 16,255,3


111111111111111111111111
100000000000000000000001
111000002000100N11111111
111111111000000000000011
100000000000000000000001
11111111111111111111111111
